###########
#E#       #
#   ## # ##
###### #  #
######### #
#       # #
# #####   #
# #   #####
# # # #####
#   #    S#
###########