###########
#E#   #   # 
# # # # # #
# # # # # #
# # # # # #
# # # # # #
# # # # # #
# # # # # #
# # # # # #
#   #   #S#
###########